0,9,9,9,9,9,9,9,9,9,9,9,9,0,9,9
0,9,6,2,4,9,9,6,2,2,2,4,9,0,9,9
0,9,3,9,3,9,9,3,9,9,9,3,9,0,9,9
0,9,3,9,3,9,9,3,9,0,9,3,9,9,9,9
0,9,3,9,3,9,9,3,9,0,9,4,2,2,2,9
9,9,3,9,3,9,9,3,9,0,9,9,9,9,9,9
2,2,7,9,5,2,2,7,9,0,0,0,0,0,9,9
9,9,9,9,9,9,9,9,9,0,0,0,0,0,9,9
